#############
#0###########
#0000000##E##
#0###0#00000#
#0###0#######
#0###000###0#
#0#000#0##00#
#E#0###0##0##
###00000000P#
#############