#############
#E###########
#0###000###E#
#0#0#0#0##00#
#0#0#0#0000##
#0000000##00#
#0####0#0000#
#0####000####
#0####0#0####
###00000000P#
#############
