################
0###########E0##
000####00####0##
0#0#####0####0##
E#000#0#0#00#00#
#00##00#000###0#
#P00#0#00#0###0#
###000##0000#00#
#####0000##000##
################