###########################
#0000000000000000000000000#
#0##0#0#0#0#0#0#0#0#0#0##0#
#0##0#0#0#0#0#0#0#0#0#0##0#
#0000000000#0#000000000000#
#0##########E#0##########0#
#0000000000E#0000000000000#
#0##########0#0#0#0#0#0##0#
#000000000000000000000000P#
###########################