##########################
#00000000000000000000000E#
#0########################
#0#0000000000000000000000#
#0#0####################0#
#0#0#000000000000000000#0#
#0#0#0################0#0#
#0#0#000000000000000E#0#0#
#0#0##################0#0#
#0#00000000000000000000#P#
#0######################0#
#000000000000000000000000#
##########################