###############
P#000000000000#
0#E##########0#
0#####00####00#
000#00000####0#
0#000##0000000#
0##############
0#
E#
##