###############################
#E####################0000000E#
#000000000000000000#000########
#000000000000000000#00##
#0000000000000000000000#
#####################0##
#0000000000000000000000#
#0000000000000000000000#
#0000000000000000000000#
#0000000000000000000000#
###########P############
########################