######################
#P############0000000#
#0############0#####0#
#00000000000000#00000#
#00000##########E#####
#00000000000#00000000#
#0##########00000000##
#0000#0000000000000###
#0#####0#0#0##########
#0000000#E#0000000000#
######################