######################
#0E###00#00#0#0#0#0#E#
000#000#000#000#00#00#
0000#0000#0000#0000#0#
###000###000###00#000#
##00#00#00#00#00#00#0#
#000#0000###000000#00#
###000##00000####00P##
######################