###################
#00#E#000000000000#
#P##000##########0#
#00#########000000#
##00000000000####0#
#00#########000000#
#000#00000000####0#
#E#000###########0#
###################